1111111111111111111111111111111111111111111111111111111
1P000000000000000000000000000000000000000000000000000E1
1000000000000000000000000000000000000000000000000000001
1001111111111100000000000000000000000000000000000000001
1001000000000100000000000000000000000000000000000000001
100100000CCCCC10000C000000000000000C000000000000C000001
100100000C000C10000C000000000000000C000000000000C000001
100000000C000C10000C000000000000000C000000000000C000001
100100000C000C10000C000000000000000C000000000000C000001
100100000CCCCC10000C000000000000000C000000000000C000001
1001000000000100000000000000000000000000000000000000001
1001000000000100000000000000000000000000000000000000001
1001111111111100000000000000000000000000000000000000001
1000000000000000000000000000000000000000000000000000001
1000000000000000000000000000000000000000000000000000001
1111111111111111111111111111111111111111111111111111111