11111111111111
1000P000000001
10000000000001
1000C000000001
10000000000001
1000000000E001
10000000000001
10000000000001
11111111111111