11111111111111
10010000000001
1001110001P101
10001000001001
1001C000011101
10001000010101
1000000C01E101
10000000010001
11111111111111