11111111111111
1001P000000001
10011100000001
10001000000001
1001C000011101
1000100000E101
1000000C000001
10000000000001
11111111111111