1111111111111111111111111111111111111111111111111111111
1001110000000100000000000000000000000000000000000000001
1001000000000100000000000000000000000000000000000000001
100100000C00010000C000000000000000C000000000000C0000001
1001000000000100000000000000000000000000000000000000001
1001000001110100000000000000000000000000000000000000001
1000000C0101010000000000000000000C000000000000000000001
1000000C01010100000000000000000000000000000000000000001
1000000001000100000000000000000000000000000000000000001
1000000000000000000000000000000C00000000000000000100001
1000000000000000000000000000000000000000000000000100001
1000000000000000000000000000000C00000000000000000100001
1000000000000001000000000000000000000000010000000100001
1000000000000000000000000000000000000000000000000000001
1000000000000000000000000000000000000100000000000000011
100000000000000000000000000000000000000E000000000000011
1000000000P00000000000000100000000000000000000000000011
1000000000000000000000000000000000000000000000000000001
1111111111111111111111111111111111111111111111111111111